
NO  ./images/greystone.xpm
SO  ./images/greystone.xpm
WE  ./images/eagle.xpm
EA  ./images/eagle.xpm
F   0,128,0                  
C   135, 206, 235

 1111111111111111111111  
100000000000000000000001   
 1000000000010000000001   
  1000N000000000000001
   100000000000000001   
    1000000010000001  
     10000010000001   
      100000000001   
       1000000001
        10000001
         100001   
          1001
           11